1111111111111111111111111111111111111111
1C00100000000000000001000000010001000001
1000000000000010000100011100000000110001
1P00100000001110000110000000000000000001
1010001000011111000000000000010000010001
1000100000000000000111000001110000100001
1C000000000000110001110000011111001000E1
1C01111100000111100000000000100100000011
1000000000000000100000000001110111100001
1100001000000110000001000001000000110001
1000001000000111110110000000100001000001
101011100000001C000110000000100000000001
1111111000010110001100000001110000010011
1111111111111111111111111111111111111111
