1111111111111111111111
1C01111100000111000011
1P001110000011100000E1
1000100001100000000111
1C00000001100011001111
1111111111111111111111
