111111111111
1CP111001101
1101100011E1
100000000001
100000000001
100000000001
100000000001
100011000001
100011000001
100111100001
100111100001
111111111111
