111111111111111111111111
1P00000000000000000000C1
100000000000000000000001
100110000000000000110001
1001000000C0000000010001
100000000000000000000001
100000000000000000000001
100100000000000000100001
1C01100000000000001100E1
111111111111111111111111
