111111111111111111111111111111111111111111111111111111111111
1000111100110000111000100000111C0011000011100111110111C00111
100000100000100000000000100001110000110000000000100000000011
100000000000000000000000000000000000000000000000000000000011
100001000000000000000000000110000000000000000000000000000011
1000P1000000000000000000001110000000000000000000000000000111
100000100000100000000000100011110000110000000000100000000011
100001000000000000000000000111000000000000000000000000000011
100011000000000000000000001110000000000000000000000000000111
100001000000000000000000011110000000000000000000000000000011
100000100000100000000000100001110000110000000000100000000011
100011000000000000000000001111100000000000000000000000000111
100000100000100000000000100001110000110000000000100000000011
100000100000100000000000100001110000110000000000100000000E11
100001000000000000000000000110000000000000000000000000000011
100000100000100000000000100001110000110000000000100000000011
100001000000000000000000000111000000000000000000000000000011
100000100000100000000000100011110000110000000000100000000011
1000110000000000000000000C1110000000000000000000000000000111
100000100000100000000000100001110000110000000000100000000011
100000100000100000000000110001110000110000000000100000000011
100011000000000000000000001110000000000000000000000000000111
100000100000100000000000100001110000110000000000100000000011
100000100000100000000000100001110000110000000000100000000011
100001000000000000000000000110C00000000000000000000000000011
100011000000000000000000001110000000000000000000000000000111
100000100000100000000000100001110000110000000000100000000011
100001100000000000000000000110000000000000000000000000000011
100001100000000000000000000110000000000000000000000000000011
111111111111111111111111111111111111111111111111111111111111
