111111111111
1CP010001101
1101001010E1
100001000001
111111111111
