1111111111111111111111
1C00100000000000000001
1P001000000011100000E1
1000100000000000000111
1C00000000000011000111
1111111111111111111111
