111111111111
1CP111001101
1101100011E1
100000100001
111111111111
