111111111111111111111111111111111111111111111111111111111111
1C00111C00111C00111C00111C00111C00111C0011100111C00111C00111
100000100000100000000000100001110000110000000000100000000011
100000000000000000000000000000000000000000000000000000000E11
100001000000000000000000000110000000000000000000000000000011
1000P1000000000000000000001110000000000000000000000000000111
100000100000100000000000100001110000110000000000100000000011
100001000000000000000000000110000000000000000000000000000011
100011000000000000000000001110000000000000000000000000000111
100001000000000000000000000110000000000000000000000000000011
100000100000100000000000100001110000110000000000100000000011
100011000000000000000000001110000000000000000000000000000111
100000100000100000000000100001110000110000000000100000000011
100000100000100000000000100001110000110000000000100000000011
100001000000000000000000000110000000000000000000000000000011
100000100000100000000000100001110000110000000000100000000011
100001000000000000000000000110000000000000000000000000000011
100000100000100000000000100001110000110000000000100000000011
100011000000000000000000001110000000000000000000000000000111
100000100000100000000000100001110000110000000000100000000011
100000100000100000000000100001110000110000000000100000000011
100011000000000000000000001110000000000000000000000000000111
100000100000100000000000100001110000110000000000100000000011
100000100000100000000000100001110000110000000000100000000011
100001000000000000000000000110000000000000000000000000000011
100011000000000000000000001110000000000000000000000000000111
100000100000100000000000100001110000110000000000100000000011
100001000000000000000000000110000000000000000000000000000011
100001000000000000000000000110000000000000000000000000000011
111111111111111111111111111111111111111111111111111111111111
